{
	"width": 16,
	"height": 16,
	"layers": {
		"floor": {
			"tiles_raw": [
				[1,1,1,1,1,1,1,1,1,1,1,1,1,1,1,1],
				[1,1,1,1,1,1,1,1,1,1,1,1,1,1,1,1],
				[1,1,1,0,0,1,1,1,1,1,1,1,1,1,1,1],
				[1,1,1,0,0,1,1,1,1,1,1,1,1,1,1,1],
				[1,1,1,0,0,1,1,1,1,1,1,1,1,1,1,1],
				[1,1,1,1,1,1,1,1,1,1,1,1,1,1,1,1],
				[1,1,1,1,1,1,1,1,1,1,1,1,1,1,1,1],
				[1,1,1,1,1,1,1,1,1,1,1,1,1,1,1,1],
				[1,1,1,1,1,1,1,1,1,1,1,1,1,1,1,1],
				[1,1,1,1,1,1,1,1,1,1,1,1,1,1,1,1],
				[1,1,1,1,1,1,1,1,1,1,1,1,0,0,1,1],
				[1,1,1,1,1,1,1,1,1,1,1,1,0,0,1,1],
				[1,1,1,1,1,1,1,1,1,1,1,1,1,1,1,1],
				[1,1,1,1,1,1,1,1,1,1,1,1,1,1,1,1],
				[1,1,1,1,1,1,1,1,1,1,1,1,1,1,1,1],
				[1,1,1,1,1,1,1,1,1,1,1,1,1,1,1,1]
			]
		},
		"walls": {
			"tiles_raw": [
				[0,0,0,0,0,0,0,2,0,0,0,0,0,0,0,0],
				[0,0,0,0,0,0,0,2,0,0,0,0,0,0,0,0],
				[0,0,0,0,0,0,0,2,0,0,0,0,0,0,0,0],
				[0,0,0,0,0,0,0,0,0,0,0,0,0,0,0,0],
				[0,0,0,0,0,0,0,0,0,0,0,0,0,0,0,0],
				[0,0,0,0,0,0,0,2,0,0,0,0,0,0,0,0],
				[2,2,2,0,2,2,2,2,0,0,0,0,0,0,0,0],
				[0,0,0,0,0,0,0,0,0,0,0,0,0,0,0,0],
				[0,0,0,0,0,0,0,0,0,0,0,0,0,0,0,0],
				[0,0,0,0,0,0,0,0,0,0,0,0,0,0,0,0],
				[0,0,0,0,0,0,0,0,0,0,0,0,0,0,0,0],
				[0,0,0,0,0,0,0,0,0,0,0,0,0,0,0,0],
				[0,0,0,0,0,0,0,0,0,0,0,0,0,0,0,0],
				[0,0,0,0,0,0,0,0,0,0,0,0,0,0,0,0],
				[0,0,0,0,0,0,0,0,0,0,0,0,0,0,0,0],
				[0,0,0,0,0,0,0,0,0,0,0,0,0,0,0,0]
			]
		},
		"triggers": {
			"tiles_raw": [
				{
					"coord": {"x": 5, "y": 1},
					"sprite_id": 3,
					"sprite_id_triggered": 5,
					"permanent": false,
					"duration": 200,
					"tiles_to_action": [1,2]
				},
				{
					"coord": {"x": 1, "y": 1},
					"sprite_id": 3,
					"sprite_id_triggered": 5,
					"permanent": true,
					"tiles_to_action": [2,3]
				}
			]
		},
		"action_tiles": {
			"tiles_raw": [
				{
					"id": 1,
					"active": false,
					"coord": {"x": 7, "y": 3},
					"sprite_id": 6,
					"sprite_id_activated": 7,
					"type": "obstacle",
					"weight": 1
				},
				{
					"id": 2,
					"active": false,
					"coord": {"x": 7, "y": 4},
					"sprite_id": 6,
					"sprite_id_activated": 7,
					"type": "obstacle",
					"weight": 2
				},
				{
					"id": 3,
					"active": false,
					"coord": {"x": 3, "y": 6},
					"sprite_id": 6,
					"sprite_id_activated": 7,
					"type": "obstacle",
					"weight": 1
				}
			]
		}
	}
}