{
	"width": 17,
	"height": 15,
	"player": {"x": 13, "y": 11, "frame": 2},
	"layers": {
		"background": {
			"tiles_raw": [
				[0,0,0,0,0,0,0,0,0,0,0,0,0,0,0,0,0],
				[0,0,0,0,0,0,0,0,2,0,0,0,0,0,0,0,2],
				[0,0,0,0,0,0,0,0,0,0,0,0,0,0,0,0,2],
				[0,0,0,0,0,0,0,0,0,0,0,0,0,0,0,0,2],
				[0,0,0,0,0,0,0,0,0,0,0,0,0,0,0,0,2],
				[0,0,0,0,0,0,0,0,3,4,4,0,0,0,0,0,2],
				[0,4,4,4,0,0,0,3,0,0,0,4,4,4,4,4,0],
				[0,0,0,0,0,0,0,2,0,0,0,0,0,0,0,0,0],
				[0,0,0,0,0,0,0,2,0,0,0,0,0,0,0,0,0],
				[0,0,0,0,0,0,0,0,2,0,0,0,0,0,0,0,2],
				[0,0,0,0,0,0,0,0,0,0,0,0,0,0,0,0,2],
				[0,0,0,0,0,0,0,0,0,0,0,0,0,0,0,0,2],
				[0,0,0,0,0,0,0,0,0,0,0,0,0,0,0,0,2],
				[0,0,0,0,0,0,0,0,3,4,4,0,0,0,0,0,2],
				[0,4,4,4,4,4,4,4,0,0,0,4,4,4,4,4,0]
			]
		},
		"floor": {
			"tiles_raw": [
				[0,0,0,0,0,0,0,0,0,0,0,0,0,0,0,0,0],
				[0,1,1,1,1,1,1,1,0,0,0,1,1,1,1,1,0],
				[0,1,1,1,1,1,1,1,1,1,1,1,1,1,1,1,0],
				[0,1,1,1,1,1,1,1,1,1,1,1,1,18,1,1,0],
				[0,1,1,1,1,1,1,1,1,1,1,1,1,1,1,1,0],
				[0,1,1,1,1,1,1,1,0,0,0,1,1,1,1,1,0],
				[0,0,0,0,1,1,1,0,0,0,0,0,0,0,0,0,0],
				[0,0,0,0,1,1,1,0,0,0,0,0,0,0,0,0,0],
				[0,0,0,0,1,1,1,0,0,0,0,0,0,0,0,0,0],
				[0,1,1,1,1,1,1,1,0,0,0,1,1,1,1,1,0],
				[0,1,1,1,1,1,1,1,1,1,1,1,1,1,1,1,0],
				[0,1,1,1,1,1,1,1,26,1,1,1,1,1,1,1,0],
				[0,1,1,1,1,1,1,1,1,1,1,1,1,1,1,1,0],
				[0,1,1,1,1,1,1,1,0,0,0,1,1,1,1,1,0],
				[0,0,0,0,0,0,0,0,0,0,0,0,0,0,0,0,0]
			]
		},
		"walls": {
			"tiles_raw": [
				[0,0,0,0,0,0,0,0,0,0,0,0,0,0,0,0,0],
				[0,0,0,0,0,0,0,0,0,0,0,0,0,0,0,0,0],
				[0,0,0,0,0,0,0,0,0,0,0,0,0,0,0,0,0],
				[0,0,0,0,0,0,0,0,0,0,0,0,0,0,0,0,0],
				[0,0,0,0,0,0,0,0,0,0,0,0,0,0,0,0,0],
				[0,0,0,0,0,0,0,0,0,0,0,0,0,0,0,0,0],
				[0,0,0,0,0,0,0,0,0,0,0,0,0,0,0,0,0],
				[0,0,0,0,0,0,0,0,0,0,0,0,0,0,0,0,0],
				[0,0,0,0,0,0,0,0,0,0,0,0,0,0,0,0,0],
				[0,0,0,0,0,0,0,0,0,0,0,0,0,0,0,0,0],
				[0,0,0,0,0,0,0,0,0,0,0,0,0,11,0,0,0],
				[0,0,0,0,0,0,0,0,0,0,0,0,0,0,0,0,0],
				[0,0,0,0,0,0,0,0,0,0,0,0,0,0,0,0,0],
				[0,0,0,0,0,0,0,0,0,0,0,0,0,0,0,0,0],
				[0,0,0,0,0,0,0,0,0,0,0,0,0,0,0,0,0]
			]
		},
		"triggers": {
			"list_raw": [
				{
					"coord": {"x": 3, "y": 11},
					"permanent": true,
					"targets": [
						{
							"type": "door",
							"id": "1"
						},
						{
							"type": "door",
							"id": "2"
						},
						{
							"type": "door",
							"id": "3"
						}
					]
				},
				{
					"coord": {"x": 6, "y": 3},
					"permanent": false,
					"targets": [
						{
							"type": "door",
							"id": "4"
						},
						{
							"type": "door",
							"id": "5"
						},
						{
							"type": "door",
							"id": "6"
						}
					]
				}
			]
		},
		"doors": {
			"list_raw": [
				{
					"id": 1,
					"opened": false,
					"coord": {"x": 4, "y": 7},
					"weight": 1
				},
				{
					"id": 2,
					"opened": false,
					"coord": {"x": 5, "y": 7},
					"weight": 1
				},
				{
					"id": 3,
					"opened": false,
					"coord": {"x": 6, "y": 7},
					"weight": 1
				},
				{
					"id": 4,
					"opened": false,
					"coord": {"x": 9, "y": 4},
					"weight": 1
				},
				{
					"id": 5,
					"opened": false,
					"coord": {"x": 9, "y": 3},
					"weight": 1
				},
				{
					"id": 6,
					"opened": false,
					"coord": {"x": 9, "y": 2},
					"weight": 1
				}
			]
		},
		"boosts": {
			"list_raw": [
			]
		},
		"portals": {
			"list_raw": [
			]
		},
		"woodboxes": {
			"coords": [
				{"x":3,"y":3}
			]
		},
		"enemies": {
			"list_raw": [
			]
		}
	}
}