{
	"width": 21,
	"height": 19,
	"player": {"x": 17, "y": 4, "frame": 1},
	"layers": {
		"background": {
			"tiles_raw": [
				[0,0,0,0,0,0,2,0,0,0,0,0,0,0,0,0,0,0,0,2,0],
				[0,0,0,0,0,0,0,2,0,0,0,0,0,0,0,0,0,0,0,0,2],
				[0,0,0,0,0,0,0,0,0,0,0,0,0,0,0,0,0,0,0,0,2],
				[0,0,0,3,0,0,0,0,0,0,0,0,0,0,0,0,0,0,0,0,2],
				[0,0,0,2,0,0,0,3,0,0,0,0,0,0,3,0,0,0,0,0,2],
				[0,0,0,2,0,0,0,2,4,4,0,0,0,0,2,4,0,0,0,0,2],
				[0,0,0,2,0,0,0,2,0,0,0,0,3,4,0,0,0,0,0,0,2],
				[0,0,0,2,0,0,0,2,0,0,0,0,0,2,0,0,0,0,0,0,2],
				[0,0,0,2,4,4,0,0,0,0,0,0,0,2,0,0,0,0,0,0,2],
				[0,0,0,2,0,0,0,0,0,0,0,0,0,2,0,0,0,0,0,0,2],
				[0,0,0,0,0,0,0,0,0,0,0,0,0,2,0,4,0,0,0,0,2],
				[0,0,0,0,0,0,0,0,0,0,0,0,0,0,2,0,0,0,0,0,2],
				[0,0,0,0,0,0,0,0,3,0,0,0,0,0,2,0,0,0,0,0,2],
				[0,0,0,0,0,0,0,0,0,0,0,0,0,0,0,0,0,0,0,0,2],
				[0,0,0,0,3,0,0,0,3,0,0,0,0,0,0,0,0,0,0,0,2],
				[0,0,0,0,2,0,0,0,0,0,0,0,0,0,0,0,0,0,0,0,2],
				[0,0,0,0,2,4,0,0,0,0,0,0,0,0,0,0,0,0,0,0,2],
				[4,0,0,0,0,0,0,0,3,0,0,0,0,0,0,0,0,0,0,3,0],
				[0,4,4,4,4,4,4,4,0,4,4,4,4,4,4,4,4,4,4,0,0]
			]
		},
		"floor": {
			"tiles_raw": [
				[0,1,1,1,1,1,0,0,0,1,1,1,1,1,1,1,1,1,1,0,0],
				[1,1,1,1,1,1,1,0,1,1,1,1,1,1,1,1,1,1,1,1,0],
				[1,1,1,1,1,1,1,1,1,1,1,1,1,1,1,1,1,1,1,1,0],
				[1,1,1,0,1,1,1,1,1,1,1,1,1,1,1,1,1,1,1,1,0],
				[1,1,1,0,1,1,1,0,1,1,1,1,1,1,0,1,1,1,1,1,0],
				[1,1,1,0,1,1,1,0,0,0,1,1,1,1,0,0,1,1,1,1,0],
				[1,1,1,0,1,1,1,0,0,0,1,1,0,0,0,0,1,1,1,1,0],
				[1,1,1,0,1,1,1,0,0,0,1,1,1,0,0,1,1,1,1,1,0],
				[1,1,1,0,0,0,1,1,1,1,1,1,1,0,0,1,1,1,1,1,0],
				[1,1,1,0,0,0,1,1,1,1,1,1,1,0,0,1,1,1,1,1,0],
				[1,1,1,1,1,1,1,1,1,1,1,1,1,0,0,0,1,1,1,1,0],
				[1,1,1,1,1,1,1,1,1,1,1,1,1,26,0,1,1,1,1,1,0],
				[1,1,1,1,1,1,1,1,0,1,1,1,1,1,0,1,1,1,1,1,0],
				[1,1,1,1,1,1,1,1,1,1,1,1,1,1,1,1,1,1,1,1,0],
				[1,1,1,1,0,1,1,1,0,1,1,1,1,1,1,1,1,1,1,1,0],
				[1,1,1,18,0,1,1,1,1,1,1,1,1,1,1,1,1,1,1,1,0],
				[1,1,1,1,0,0,1,1,1,1,1,1,1,1,1,1,1,1,1,1,0],
				[0,1,1,1,1,1,1,1,0,1,1,1,1,1,1,1,1,1,1,0,0],
				[0,0,0,0,0,0,0,0,0,0,0,0,0,0,0,0,0,0,0,0,0]
			]
		},
		"walls": {
			"tiles_raw": [
				[0,5,5,5,5,5,0,0,0,5,5,5,5,5,5,5,5,5,5,0,0],
				[5,0,0,0,0,0,5,0,5,0,0,0,0,0,0,0,0,0,6,5,0],
				[5,0,0,0,0,0,0,5,0,0,0,0,0,0,0,5,0,0,0,5,0],
				[5,0,0,0,0,0,0,0,0,9,0,0,0,0,0,5,0,0,0,5,0],
				[5,0,0,0,0,0,0,0,0,0,0,5,0,0,0,5,10,0,0,5,0],
				[5,0,0,0,0,0,0,0,0,0,0,0,0,0,0,0,5,5,5,5,0],
				[5,0,0,0,0,0,0,0,0,0,0,0,0,0,0,0,0,0,0,5,0],
				[5,0,0,0,0,0,0,0,0,0,5,0,0,0,0,0,0,0,0,5,0],
				[5,0,0,0,0,0,0,0,0,0,5,0,0,0,0,0,0,5,0,5,0],
				[5,0,0,0,0,0,0,0,0,0,5,5,0,0,0,0,0,0,0,5,0],
				[5,0,5,5,5,8,5,5,5,0,5,5,0,0,0,0,0,0,0,5,0],
				[5,0,5,0,0,0,0,0,0,0,0,5,0,0,0,0,0,0,0,5,0],
				[5,0,5,0,0,0,0,0,0,0,0,5,0,0,0,0,5,0,0,5,0],
				[5,0,5,5,0,0,5,0,0,0,0,5,0,0,0,0,0,0,0,5,0],
				[5,0,0,0,0,0,0,0,0,0,0,5,5,0,0,0,0,0,0,5,0],
				[5,0,0,0,0,0,0,0,0,0,0,5,5,5,5,5,5,0,0,5,0],
				[5,0,0,0,0,0,0,0,5,0,0,0,0,0,0,0,0,0,0,5,0],
				[0,5,5,5,5,5,5,5,0,5,5,5,5,5,5,5,5,5,5,0,0],
				[0,0,0,0,0,0,0,0,0,0,0,0,0,0,0,0,0,0,0,0,0]
			]
		},
		"triggers": {
			"list_raw": [
				{
					"coord": {"x": 11, "y": 2},
					"permanent": false,
					"targets": [
						{
							"type": "door",
							"id": "3"
						}
					]
				},
				{
					"coord": {"x": 12, "y": 13},
					"permanent": false,
					"targets": [
						{
							"type": "door",
							"id": "2"
						}
					]
				},
				{
					"coord": {"x": 5, "y": 12},
					"permanent": false,
					"targets": [
						{
							"type": "door",
							"id": "1"
						}
					]
				},
				{
					"coord": {"x": 4, "y": 7},
					"permanent": false,
					"targets": [
						{
							"type": "door",
							"id": "4"
						}
					]
				}
			]
		},
		"doors": {
			"list_raw": [
				{
					"id": 1,
					"opened": false,
					"coord": {"x": 1, "y": 10},
					"weight": 1
				},
				{
					"id": 2,
					"opened": false,
					"coord": {"x": 1, "y": 11},
					"weight": 1
				},
				{
					"id": 3,
					"opened": false,
					"coord": {"x": 1, "y": 12},
					"weight": 1
				},
				{
					"id": 4,
					"opened": false,
					"coord": {"x": 1, "y": 13},
					"weight": 1
				}
			]
		},
		"boosts": {
			"list_raw": [
			]
		},
		"portals": {
			"list_raw": [
			]
		},
		"woodboxes": {
			"coords": [
				{"x": 17, "y":7},
				{"x": 8, "y":9},
				{"x": 7, "y": 8},
				{"x": 11, "y": 7}
			]
		},
		"enemies": {
			"list_raw": [
			]
		}
	}
}