{
	"width": 20,
	"height": 20,
	"player": {"x": 11, "y": 6,"frame":2},
	"layers": {
		"background": {
			"tiles_raw": [
				[0,0,0,0,0,0,0,0,0,0,0,0,0,0,2,0,0,0,0,0],
				[0,0,0,0,0,0,0,0,0,0,0,0,0,0,2,0,0,0,0,0],
				[0,0,0,0,0,0,0,0,0,0,0,0,0,0,2,0,0,0,0,0],
				[0,0,0,0,0,0,0,0,0,0,0,0,0,0,2,0,0,0,0,0],
				[0,0,0,0,0,0,0,0,0,0,0,0,0,0,2,0,0,0,0,0],
				[0,0,0,3,0,3,4,4,4,0,0,0,0,0,2,0,0,0,0,0],
				[0,0,0,2,0,2,0,0,2,0,0,0,0,0,2,0,0,0,0,0],
				[0,0,0,2,0,2,0,0,2,0,0,0,0,0,2,0,0,0,0,0],
				[0,0,0,2,0,2,0,0,2,0,0,0,0,0,2,0,0,0,0,0],
				[4,4,4,0,0,2,4,4,0,0,0,0,0,0,2,0,0,0,0,0],
				[0,0,0,0,0,0,2,0,0,0,0,0,0,0,2,0,0,0,0,0],
				[0,0,0,0,0,0,0,0,0,0,0,0,0,0,2,0,0,0,0,0],
				[0,0,0,0,0,0,0,0,0,0,0,0,0,0,2,0,0,0,0,0],
				[0,0,0,0,0,0,0,0,0,0,0,0,0,0,2,0,0,0,0,0],
				[0,0,0,0,0,0,3,0,0,0,0,0,0,0,2,0,0,0,0,0],
				[4,4,4,4,4,4,0,4,4,4,4,4,4,4,0,0,0,0,0,0],
				[0,0,0,0,0,0,0,0,0,0,0,0,0,0,0,0,0,0,0,0],
				[0,0,0,0,0,0,0,0,0,0,0,0,0,0,0,0,0,0,0,0],
				[0,0,0,0,0,0,0,0,0,0,0,0,0,0,0,0,0,0,0,0],
				[0,0,0,0,0,0,0,0,0,0,0,0,0,0,0,0,0,0,0,0]
			]
		},
		"floor": {
			"tiles_raw": [
				[1,1,1,1,1,1,1,1,1,1,1,1,1,1,0,0,0,0,0,0],
				[1,1,1,1,1,1,1,1,1,1,1,1,1,1,0,0,0,0,0,0],
				[1,1,1,1,1,1,1,1,1,1,1,1,1,1,0,0,0,0,0,0],
				[1,1,1,1,1,1,1,1,1,1,1,1,1,1,0,0,0,0,0,0],
				[1,1,1,1,1,1,1,1,1,1,1,1,1,1,0,0,0,0,0,0],
				[1,1,1,0,1,0,0,0,0,1,1,1,1,1,0,0,0,0,0,0],
				[1,1,1,0,1,0,1,1,0,1,1,1,1,1,0,0,0,0,0,0],
				[1,26,1,0,1,0,1,1,0,1,1,1,1,1,0,0,0,0,0,0],
				[1,1,1,0,1,0,18,1,0,1,1,1,1,1,0,0,0,0,0,0],
				[0,0,0,0,1,0,0,0,0,1,1,1,1,1,0,0,0,0,0,0],
				[1,1,1,1,1,1,0,1,1,1,1,1,1,1,0,0,0,0,0,0],
				[1,1,1,1,1,1,1,1,1,1,1,1,1,1,0,0,0,0,0,0],
				[1,1,1,1,1,1,1,1,1,1,1,1,1,1,0,0,0,0,0,0],
				[1,1,1,1,1,1,1,1,1,1,1,1,1,1,0,0,0,0,0,0],
				[1,1,1,1,1,1,0,1,1,1,1,1,1,1,0,0,0,0,0,0],
				[0,0,0,0,0,0,0,0,0,0,0,0,0,0,0,0,0,0,0,0],
				[0,0,0,0,0,0,0,0,0,0,0,0,0,0,0,0,0,0,0,0],
				[0,0,0,0,0,0,0,0,0,0,0,0,0,0,0,0,0,0,0,0],
				[0,0,0,0,0,0,0,0,0,0,0,0,0,0,0,0,0,0,0,0],
				[0,0,0,0,0,0,0,0,0,0,0,0,0,0,0,0,0,0,0,0]
			]
		},
		"walls": {
			"tiles_raw": [
				[6,0,0,0,0,0,0,0,0,0,0,0,0,0,0,0,0,0,0,0],
				[0,0,0,0,0,0,0,0,0,0,0,0,0,0,0,0,0,0,0,0],
				[0,0,0,0,0,0,0,0,0,0,0,0,0,0,0,0,0,0,0,0],
				[0,0,0,0,0,0,0,0,0,0,0,0,0,0,0,0,0,0,0,0],
				[0,0,0,0,0,0,0,0,5,5,5,5,5,5,0,0,0,0,0,0],
				[0,0,0,0,0,0,0,0,0,0,0,11,0,0,0,0,0,0,0,0],
				[0,0,0,0,0,0,0,0,0,0,0,0,0,0,0,0,0,0,0,0],
				[0,0,0,0,0,0,0,0,0,0,0,0,0,0,0,0,0,0,0,0],
				[0,0,0,0,0,0,0,0,0,0,0,0,0,0,0,0,0,0,0,0],
				[0,0,0,0,0,0,0,0,0,0,0,0,0,0,0,0,0,0,0,0],
				[0,0,0,0,0,0,0,0,0,0,0,0,0,0,0,0,0,0,0,0],
				[0,0,0,0,0,0,0,0,0,0,0,0,0,0,0,0,0,0,0,0],
				[0,0,0,0,5,0,0,0,0,0,0,0,0,0,0,0,0,0,0,0],
				[0,0,0,0,0,0,0,0,0,0,0,0,0,0,0,0,0,0,0,0],
				[0,0,0,0,0,0,0,0,0,0,0,0,0,0,0,0,0,0,0,0],
				[0,0,0,0,0,0,0,0,0,0,0,0,0,0,0,0,0,0,0,0],
				[0,0,0,0,0,0,0,0,0,0,0,0,0,0,0,0,0,0,0,0],
				[0,0,0,0,0,0,0,0,0,0,0,0,0,0,0,0,0,0,0,0],
				[0,0,0,0,0,0,0,0,0,0,0,0,0,0,0,0,0,0,0,0],
				[0,0,0,0,0,0,0,0,0,0,0,0,0,0,0,0,0,0,0,0]
			]
		},
		"triggers": {
			"list_raw": [
				{
					"coord": {"x": 6, "y": 0},
					"permanent": false,
					"targets": [
						{
							"type": "boost",
							"id": 1 
						},
						{
							"type": "boost",
							"id": 2 
						},
						{
							"type": "boost",
							"id": 3 
						},
						{
							"type": "boost",
							"id": 4 
						}
					]
				}
			]
		},
		"doors": {
			"list_raw": [
			]
		},
		"boosts": {
			"list_raw": [
				{
					"id": 1,
					"active": false,
					"coord": {"x": 8, "y": 0},
					"direction": 1,
					"direction_activated": -1,
					"weight": 1
				},
				{
					"id": 2,
					"active": false,
					"coord": {"x": 8, "y": 1},
					"direction": 1,
					"direction_activated": -1,
					"weight": 1
				},
				{
					"id": 3,
					"active": false,
					"coord": {"x": 8, "y": 2},
					"direction": 1,
					"direction_activated": -1,
					"weight": 1
				},
				{
					"id": 4,
					"active": false,
					"coord": {"x": 8, "y": 3},
					"direction": 1,
					"direction_activated": -1,
					"weight": 1
				}
			]
		},
		"portals": {
			"list_raw": [
				{
					"id": 1,
					"active": true,
					"coord": {"x": 12, "y": 1},
					"sprite_id": 19,
					"sprite_id_activated": 24,
					"weight": 1,
					"portal_to": 2
				},
				{
					"id": 2,
					"active": true,
					"coord": {"x": 7, "y": 6},
					"sprite_id": 19,
					"sprite_id_activated": 24,
					"weight": 1,
					"portal_to": 1
				}
			]
		},
		"woodboxes": {
			"coords": [
				{"x":3,"y":12},
				{"x":9,"y":1},
				{"x":7,"y":12},
				{"x":6,"y":13},
				{"x":5,"y":11},
				{"x":5,"y":13},
				{"x":5,"y":14},
				{"x":6,"y":11},
				{"x":7,"y":14}
			]
		},
		"enemies": {
			"list_raw": [
				{
					"coord": {"x": 1, "y":0},
					"direction": 0
				},
				{
					"coord": {"x": 10, "y":8},
					"direction": 1
				}
			]
		}
	}
}